###########################################
                               ####       E
##### ############################# #######
##### ####                              ###
##### ################################# ###
##### #################          ###### ###
#####      ############ ######## ###### ###
##### ####              ######## ####   ###
##### ######### ################ #### #####
##### ########################## #### #####
##### ######                     #### #####
##### ############# #################     #
#                ## #### ############ #####
##### ############# #### ############ #####
##### #############                   #####
###########################################