###########################################
#       ###################################
####### #                                ##
        # ########### #####################
####### # ########### ##### ############ ##
####### #     ####### #####              ##
#       ##### ####### ################## ##
####### ##### ##                ####     ##
##      ##### ################# #### ### ##
## ########## ################# #### ### ##
##         ##               ### #### ### ##
## ######################## ###      ### ##
##               ########## ############ ##
## ############# ########## ####         ##
##           ###            #### ##########
################################E##########